.....OOOO.OOOOOOO
......OOOOO.OOOOO
..........OOOOOOO
..........O.ooOOO
............OOOOO
.............OOOO
............OOOOO
.............OOOO
.............OOOO
............OOOOO
...........OOOOOO
...........OOOOOO
...........OOOOOO
..........OOOOOXO
...........OOOOOO
